level,exp,hp,mp,p_atk,m_atk,p_defend,m_defend,hit,dodge,crit,dechp,speed,end
1,100,100,10,5,5,1,1,1,1,1,0,1,0
2,200,150,20,10,10,2,2,1,2,1,0,1,0
3,300,200,30,15,15,3,3,2,2,1,0,1,0
4,400,250,40,20,20,4,4,2,2,1,0,1,0
5,500,300,50,25,25,5,5,3,2,1,0,1,0
6,600,350,60,30,30,6,6,3,3,1,1,1,0
7,700,400,70,35,35,7,7,3,3,2,1,1,0
8,800,450,80,40,40,8,8,4,3,2,1,1,0
9,900,500,90,45,45,9,9,4,3,2,1,1,0
10,1000,550,100,50,50,10,10,4,3,2,1,1,0
